{
  "level": 2,
  "width":8,
  "height":5 ,
  "layout": [
    [2, 0, 2, 0, 2, 0, 2, 0],
    [2, 2, 2, 2, 2, 2, 2, 2],
    [1, 1, 1, 1, 1, 1, 1, 1],
    [0, 1, 0, 2, 2, 2, 2, 2],
    [1, 1, 1, 1, 1, 1, 1, 1]
  ]
}